####################
#  #        ####   #
#  #               #
#        #######   #
#   ##     #####   #
#                  #
#                  #
#                  #
#                  #
#                  #
#                  #
#                  #
#                  #
#                  #
#                  #
#                  #
#                  #
#                  #
#                  #
####################